-10
9
-5
5
11111111111111111111
10000000111111111111
10000000111111111111
10000000111111111111
10000000111111101111
00000000111111111111
10000000111111111111
10000000111111111111
11111111111111111111
11111111111111111111
11111111111111111101
